3	3	3	3	3	3	3	3	3	3	3	3	3	3	3	3	3	3	3
3	0	0	0	0	0	0	0	0	0	0	0	0	0	0	0	0	0	0
3	0	0	0	5	0	5	0	5	0	0	0	0	0	0	0	0	0	0
3	0	-1	0	0	0	0	0	0	0	0	-1	0	0	0	-1	0	0	0
3	0	0	0	0	0	0	0	0	0	0	0	0	0	0	0	0	0	0
3	0	0	0	0	0	0	0	0	0	0	0	0	0	0	0	0	0	0
3	0	5	0	0	0	0	0	0	0	0	0	0	0	0	0	0	0	0
3	0	0	0	0	0	0	0	0	0	0	0	0	0	0	0	0	0	0
3	0	5	0	0	0	0	0	5	0	5	0	5	0	5	0	5	0	0
3	0	0	0	0	0	0	0	0	0	0	0	0	0	0	0	0	0	0
3	0	5	0	0	0	0	5	0	3	3	3	3	3	3	3	3	3	3
3	0	0	0	0	0	0	0	0	3	3	3	3	3	3	3	3	3	3
3	0	5	0	0	0	0	5	0	3	3	3	3	3	3	3	3	3	3
3	0	0	0	0	0	0	0	0	3	3	3	3	3	3	3	3	3	3
3	0	5	0	0	0	0	5	0	3	3	3	4	4	4	4	4	4	4
3	0	0	0	0	0	0	0	0	3	3	3	4	3	3	3	3	3	3
3	0	5	0	0	0	0	0	0	3	3	3	4	3	3	3	3	3	3
3	0	0	0	0	0	0	-1	0	3	3	3	4	3	3	3	3	3	3
3	-1	0	0	0	0	0	0	0	3	3	3	4	3	3	3	3	3	3
3	0	0	0	0	0	0	0	0	3	3	3	4	3	3	3	3	3	3
